DATA_PROVIDER	provider_aggregation_edm_dataProvider.*	1712483
text	proxy_dcterms_alternative.*,proxy_dc_contributor.*,proxy_dc_coverage.*,proxy_dcterms_created.*,proxy_dc_creator.*,proxy_dc_date.*,proxy_dc_description.*,proxy_dcterms_issued.*,proxy_dc_language.*,proxy_dcterms_provenance.*,proxy_dc_publisher.*,proxy_dc_rights.*,proxy_dc_source.*,proxy_dcterms_spatial.*,proxy_dc_subject.*,proxy_dcterms_temporal.*,proxy_dc_title.*,proxy_dc_type.*,proxy_dc_format.*,proxy_dcterms_medium.*,provider_aggregation_dc_rights.*,provider_aggregation_edm_dataProvider.*,provider_aggregation_edm_provider.*,provider_aggregation_edm_intermediateProvider.*,wr_dc_creator.*,wr_dc_description.*,proxy_edm_type,ag_skos_prefLabel.*,ag_skos_altLabel.*,org_skos_prefLabel.*,org_skos_altLabel.*,ts_skos_prefLabel.*,ts_skos_altLabel.*,cc_skos_prefLabel.*,cc_skos_altLabel.*	168199
identifier	proxy_dc_identifier	139574
PROVIDER	provider_aggregation_edm_provider.*	98999
TYPE	proxy_edm_type	86129
what	proxy_dc_type.*,proxy_dc_subject.*,cc_skos_prefLabel.*,cc_skos_altLabel.*	70045
pl_wgs84_pos_long	---	60545
pl_wgs84_pos_lat	---	60489
europeana_collectionName	---	55723
title	proxy_dc_title.*,proxy_dcterms_alternative.*	45866
who	proxy_dc_contributor.*,proxy_dc_creator.*,ag_skos_prefLabel.*,ag_skos_altLabel.*,ag_foaf_name.*	27165
YEAR	proxy_edm_year.*	19092
europeana_id	---	5906
edm_datasetName	europeana_collectionName	4404
where	proxy_dcterms_spatial.*,pl_skos_prefLabel.*,pl_skos_altLabel.*	452
proxy_dc_description	proxy_dc_description.*	418
provider_aggregation_edm_isShownBy	---	112
RIGHTS	provider_aggregation_edm_rights.*,provider_aggregation_odrl_inherited_from	52
when	proxy_dcterms_created.*,proxy_dcterms_temporal.*,proxy_dc_date.*,ts_skos_prefLabel.*,ts_skos_altLabel.*,proxy_edm_year.*,proxy_dcterms_issued.*	42
subject	proxy_dc_subject.*,proxy_dc_coverage.*,proxy_dcterms_spatial.*,proxy_dcterms_temporal.*	38
proxy_dc_identifier	proxy_dc_identifier.*	23
COUNTRY	europeana_aggregation_edm_country.*	18
proxy_dc_creator	proxy_dc_creator.*	10
ag_owl_sameAs	ag_owl_sameAs.*	7
LANGUAGE	europeana_aggregation_edm_language.*	6
provider_aggregation_edm_dataProvider	provider_aggregation_edm_dataProvider.*	4
edm_agent	---	4
provider_aggregation_edm_provider	provider_aggregation_edm_provider.*	4
proxy_dc_title	proxy_dc_title.*	3
has_thumbnails	---	1
wr_svcs_hasservice	---	1
