DATA_PROVIDER	provider_aggregation_edm_dataProvider.*	7682322
what	proxy_dc_type.*,proxy_dc_subject.*,cc_skos_prefLabel.*,cc_skos_altLabel.*	3506314
PROVIDER	provider_aggregation_edm_provider.*	2048163
TYPE	proxy_edm_type	1335605
edm_datasetName	europeana_collectionName	666379
provider_aggregation_edm_isShownBy	---	527940
europeana_collectionName	---	465534
LANGUAGE	europeana_aggregation_edm_language.*	245547
who	proxy_dc_contributor.*,proxy_dc_creator.*,ag_skos_prefLabel.*,ag_skos_altLabel.*,ag_foaf_name.*	212660
title	proxy_dc_title.*,proxy_dcterms_alternative.*	209503
COUNTRY	europeana_aggregation_edm_country.*	204196
RIGHTS	provider_aggregation_edm_rights.*,provider_aggregation_odrl_inherited_from	34336
YEAR	proxy_edm_year.*	14293
proxy_dcterms_created	proxy_dcterms_created.*	6943
where	proxy_dcterms_spatial.*,pl_skos_prefLabel.*,pl_skos_altLabel.*	5135
proxy_dcterms_isPartOf	proxy_dcterms_isPartOf.*	814
pl_wgs84_pos_lat	---	185
pl_wgs84_pos_long	---	170
has_media	---	155
UGC	edm_UGC	154
proxy_dc_description	proxy_dc_description.*	92
has_thumbnails	---	85
proxy_dc_subject	proxy_dc_subject.*	58
COMPLETENESS	europeana_completeness	40
when	proxy_dcterms_created.*,proxy_dcterms_temporal.*,proxy_dc_date.*,ts_skos_prefLabel.*,ts_skos_altLabel.*,proxy_edm_year.*,proxy_dcterms_issued.*	35
provider_aggregation_edm_object	---	19
provider_aggregation_edm_hasView	---	13
proxy_dc_title	proxy_dc_title.*	12
provider_aggregation_edm_isShownAt	---	8
text	proxy_dcterms_alternative.*,proxy_dc_contributor.*,proxy_dc_coverage.*,proxy_dcterms_created.*,proxy_dc_creator.*,proxy_dc_date.*,proxy_dc_description.*,proxy_dcterms_issued.*,proxy_dc_language.*,proxy_dcterms_provenance.*,proxy_dc_publisher.*,proxy_dc_rights.*,proxy_dc_source.*,proxy_dcterms_spatial.*,proxy_dc_subject.*,proxy_dcterms_temporal.*,proxy_dc_title.*,proxy_dc_type.*,proxy_dc_format.*,proxy_dcterms_medium.*,provider_aggregation_dc_rights.*,provider_aggregation_edm_dataProvider.*,provider_aggregation_edm_provider.*,provider_aggregation_edm_intermediateProvider.*,wr_dc_creator.*,wr_dc_description.*,proxy_edm_type,ag_skos_prefLabel.*,ag_skos_altLabel.*,org_skos_prefLabel.*,org_skos_altLabel.*,ts_skos_prefLabel.*,ts_skos_altLabel.*,cc_skos_prefLabel.*,cc_skos_altLabel.*	7
europeana_id	---	7
proxy_dc_date	proxy_dc_date.*	7
wr_svcs_hasservice	---	5
wr_dcterms_isReferencedBy	---	3
proxy_dc_identifier	proxy_dc_identifier.*	3
proxy_dc_type	proxy_dc_type.*	2
proxy_dc_format	proxy_dc_format.*	1
sv_dcterms_conformsTo	---	1
proxy_dcterms_spatial	proxy_dcterms_spatial.*	1
